88888888888888888888888888888888
88888999999987653210001134567888
88899986310135783210001123566777
88998510368817042260700123456666
88983037310125673220060123345555
89950487043876530260300152334444
89813810267024662240500114222333
89607706605765405200400021111222
89333026320023552110020000011111
89161460256645031120310010000000
89080375063053440130020010000000
89181807060605030100000000000000
88312726245012230211100000000000
87575645353524130201010101111111
86706564504021121201010101111111
85847360534333201202020202121222
83323025210000113202202222222222
82222222111122222333333333333333
81162640123010000303013322333333
80000000000011122333443333333333
80070354030010002304214424434444
80006000212001120314144434444444
81100000000000002333444444444444
81111110000001122333444444444444
83222512011000002323234444444444
84333241000001122323444444444444
85543321000001112333444444444444
86654321100001122333344444444444
87665421100001112333444444444444
88765432100001122333444444444444
88765432100001122333444444444444
88765432100001122333444444444444
