55555555555555555555555555555555
57654332223222233344444322233444
56432322344422343445544333333444
55322344234343433435444444443344
54223423345433343344534445544444
53334244533343445444544445554444
53242444334444344344444454554444
52243444344434444343444445544555
52323533345445443352244445445555
52434334444544455252443344455565
53445344545445442242553354465666
52434344454545434232322333455555
52243443444455444242553336445554
52233344545554544242424344444554
52343434444445455252525355444454
53434444454344545362625355545554
53333544352444553332253444444444
53443433322222233333333344444434
54434444554344563343543445444333
54554443222222222334444444443323
54545544245354562354454444433222
54443444445252225344544444443322
54444444433234553334444444443323
53344444433333334344444444433323
52344454445334554444444432333333
52345545544364554454444423223344
52345555444444454444444432333333
53344554456544444444344332322322
53334444555554454443333333322222
54434445556555454433233333332212
54444445566555554332222234322112
54444445556544444433223334322222
